"","uuid","datetime","species","number_morbidity","disease_id","number_mortality","total_number_cases","location"
"1","05a170b6-0bc4-41e6-9dd9-b9b30313b2d8","05-05-21 15:38","pig",5,5,0,5,"Village 3"
"2","72a5399d-a035-4324-9f47-feb2bb1eb4a0","03-05-21 12:11","cat",2,4,0,2,"Village 3"
"3","2ad7d909-2792-4851-a932-7ad37cd8c64c","11-05-21 15:06","chicken",5,9,2,7,"Village 2"
"4","713f6f60-35b1-4edb-8b09-2453aad44278","07-05-21 15:36","dog",4,3,0,4,"Health Centre B"
"5","f22dfebf-cd72-4e3e-beab-58c93aad82d9","11-05-21 16:06","sheep",1,3,2,3,"Village 3"
"6","baa67d98-ddc7-4545-8739-59fb7489331f","04-05-21 11:55","cat",1,7,0,1,"Village 1"
"7","bbef2885-b326-49dd-b449-c088ac86c469","01-05-21 11:08","dog",2,0,5,7,"Health Centre A"
"8","e8e29406-1445-4b95-9e9a-afbfc9b0df03","07-05-21 17:54","sheep",4,3,2,6,"Village 3"
"9","6301292b-46f1-44ea-b0f1-7116faf9140f","28-04-21 9:11","cat",1,6,0,1,"Village 3"
"10","08440197-3102-4a18-818e-4a4b73e21310","01-05-21 16:24","pig",5,7,2,7,"Health Centre B"
"11","cdfc1b84-0d78-44cf-9726-e68dc576410e","11-05-21 10:55","buffalo",4,1,0,4,"Village 3"
"12","61a53b29-6c28-4793-bbce-825067514e22","11-05-21 11:01","dog",4,5,5,9,"Village 3"
"13","40f88af6-931d-4877-85d9-cd5dcc6a0926","06-05-21 15:37","pig",6,6,2,8,"Health Centre A"
"14","d1a8b8bf-44fb-4eac-ad20-db27111f5a7e","01-05-21 12:05","pig",6,5,5,11,"Village 3"
"15","f5ddb2f9-19eb-4613-8623-cdc2fd75fa3e","01-05-21 15:49","sheep",2,0,0,2,"Village 2"
"16","8a4fadc5-6855-4fcb-8c6a-de0f983bdfa5","04-05-21 18:10","dog",3,2,4,7,"Health Centre A"
"17","62f1031e-7da7-4cea-9b63-a1971f6ac32a","08-05-21 9:51","buffalo",3,7,1,4,"Village 2"
"18","85aa86cc-430e-4c83-9653-d47ee48413f7","01-05-21 13:03","chicken",5,5,2,7,"Village 3"
"19","3f13e312-8ced-4bdb-b309-43a4c21fa5b7","30-04-21 11:58","pig",6,3,3,9,"Village 2"
"20","62fb7022-6ed3-4601-a0d8-d2c9ea1ac57c","08-05-21 18:41","cat",6,9,1,7,"Village 2"
"21","c5d180d7-08ba-48d8-a96b-01931d14ff3e","27-04-21 15:41","sheep",4,3,1,5,"Village 2"
"22","8435b592-2dd9-4102-bfcc-ed5e505fc418","05-05-21 17:17","buffalo",3,0,0,3,"Village 3"
"23","8d3012df-5eda-4c56-8d43-b17cfddeebcb","28-04-21 10:44","chicken",3,1,0,3,"Village 3"
"24","f5ed5135-b584-42ae-9217-bce47b3f320a","11-05-21 15:17","cat",6,1,3,9,"Village 2"
"25","432214fd-d7c8-4540-b458-8f96d853eaf4","30-04-21 10:01","dog",6,6,3,9,"Village 1"
"26","6983542f-5cea-44ed-a37e-d8877820ca6c","06-05-21 17:47","buffalo",3,9,4,7,"Health Centre B"
"27","d9e1e28b-05db-4d90-8531-8611c1d02f48","01-05-21 9:45","cat",3,5,1,4,"Village 2"
"28","861b5c65-6129-4b69-b948-503c590ab10a","07-05-21 13:18","dog",2,5,0,2,"Village 1"
"29","157c8ec4-8bea-424c-8ddc-09570e057198","27-04-21 10:14","sheep",3,4,2,5,"Village 1"
"30","b8c7cc2e-bf6b-4a6c-8f8e-946be8d7e8a1","03-05-21 13:04","dog",4,1,5,9,"Health Centre B"
"31","8a7d32cb-3f5d-415f-8f98-f54392005c0b","05-05-21 17:27","pig",4,4,1,5,"Health Centre A"
"32","6c345ed4-2006-48ae-88f4-37abb57f679f","09-05-21 13:54","chicken",5,1,1,6,"Village 3"
"33","1be75581-fe0c-4efc-a90b-6db41cf90dc7","28-04-21 17:19","pig",5,0,1,6,"Health Centre A"
"34","5dfad94a-6a72-49f8-980c-b5751e60449c","01-05-21 14:07","cat",2,7,0,2,"Health Centre A"
"35","f825f7ec-03ce-44d7-a3e0-2feaec939e40","27-04-21 10:57","buffalo",1,1,0,1,"Village 2"
"36","a1b6039f-1312-4f9c-9943-c299441a5cf0","30-04-21 15:44","sheep",4,7,0,4,"Health Centre B"
"37","d874f16d-52ec-4f05-a27f-148b20289aa5","08-05-21 12:46","pig",2,3,4,6,"Village 1"
"38","2bebff3e-10e0-462c-bc9d-c2a783511c34","30-04-21 9:41","chicken",1,7,2,3,"Health Centre A"
"39","ec0e9474-c3ea-4030-9578-759750eb3e8f","30-04-21 17:28","buffalo",2,7,3,5,"Village 2"
"40","12847969-9f7a-44d4-b43e-d81a08bec1ff","07-05-21 18:32","pig",4,2,0,4,"Village 1"
"41","8b188c27-2c8f-4e6b-a9b6-083bb4698fb2","07-05-21 10:21","buffalo",3,7,0,3,"Health Centre B"
"42","9e789794-c883-4dda-b2e5-32fbc0602e69","06-05-21 14:23","chicken",1,8,0,1,"Health Centre B"
"43","604ee9ca-53de-48d1-b54a-31c3dcf04cfa","11-05-21 11:43","buffalo",6,2,3,9,"Village 3"
"44","ffb877e4-f67a-43f2-b375-1660c021146f","27-04-21 12:17","sheep",2,2,4,6,"Village 3"
"45","fa769153-e82c-40d6-b578-a0964847fb79","11-05-21 9:50","dog",5,2,0,5,"Village 1"
"46","6e6cb751-24b5-4ce3-9d45-05d4da0af053","01-05-21 14:24","sheep",2,3,3,5,"Village 3"
"47","755cce86-cb2d-4637-bb2c-7f98395edba7","04-05-21 10:53","sheep",5,7,5,10,"Health Centre B"
"48","34b86361-5b57-45d9-a8d4-0bf01b2f1f34","03-05-21 11:46","cat",1,4,0,1,"Village 2"
"49","4baa9405-3e8d-4aea-af05-40643375d266","27-04-21 14:19","buffalo",5,4,0,5,"Health Centre A"
"50","3ea65920-08eb-4af7-80be-1844b490292a","03-05-21 11:10","dog",1,3,2,3,"Village 3"
"51","0e97e1d5-72e4-4eb5-bc0f-6ad03930cb90","03-05-21 9:37","sheep",1,9,0,1,"Village 3"
"52","42dc62d6-4f12-48f5-9623-72c23a722408","30-04-21 17:12","dog",5,5,4,9,"Village 2"
"53","afba92d0-e60a-41cb-a754-8fef3786b107","06-05-21 10:55","sheep",3,1,0,3,"Village 2"
"54","02fcf424-b6e7-4c89-8cf7-e1aea31ceeda","07-05-21 15:31","sheep",1,6,4,5,"Village 1"
"55","abfb1109-f367-4aa1-97cd-27c197bff804","11-05-21 9:55","cat",1,5,1,2,"Village 2"
"56","33a0f9a5-c65d-49a8-a6d9-388ba126b93a","03-05-21 18:42","cat",6,0,3,9,"Health Centre B"
"57","ecd58141-60e8-4a6b-880f-d82ec15ba2de","10-05-21 10:31","dog",5,2,4,9,"Health Centre B"
"58","b4881330-8fa2-4bdd-9c3c-349809dafe30","03-05-21 17:19","dog",2,0,0,2,"Village 1"
"59","932e0739-05ee-46b5-ad1a-0fe2f9ddb6e8","09-05-21 15:24","dog",5,1,2,7,"Village 1"
"60","a64ae813-e7e4-4b76-b524-fe0c3a1e559a","29-04-21 12:20","sheep",1,5,2,3,"Village 3"
"61","aff63e5d-308f-4e3c-8c79-9ebf0b25b00a","30-04-21 17:26","buffalo",5,8,2,7,"Health Centre B"
"62","36132179-ebb9-40cc-8d5e-ff6560bd639e","30-04-21 9:45","buffalo",4,9,5,9,"Village 1"
"63","6ab1ec23-fbc5-4bf2-8ef7-ca7f90d95a88","30-04-21 17:26","dog",4,2,5,9,"Village 1"
"64","6003ce42-084c-48a6-a5da-5e3cef3ed191","09-05-21 13:19","pig",1,3,5,6,"Village 1"
"65","a79c93b3-7fdc-4428-9e91-efc272a27eef","29-04-21 18:29","cat",4,8,0,4,"Village 3"
"66","e4fa3e07-2f89-49d1-85e3-d9c5525f63de","06-05-21 9:19","pig",2,8,2,4,"Village 3"
"67","027329e3-14a2-48d3-8876-f6a88fabe8ba","27-04-21 16:00","cat",3,9,4,7,"Health Centre A"
"68","3344629f-dcc0-454b-904a-0bb254a94a04","10-05-21 10:05","cat",4,4,4,8,"Health Centre B"
"69","ab677652-bf1d-4e01-a578-f85a3444d3c7","11-05-21 10:16","sheep",3,3,3,6,"Village 2"
"70","07b765be-3264-41be-8535-4be29e5a61f5","07-05-21 13:26","pig",5,3,5,10,"Health Centre A"
"71","9234ee97-bff3-490f-8243-b836055e3c94","07-05-21 16:47","pig",4,0,0,4,"Health Centre B"
"72","ba690167-0567-4177-9762-867fa702df94","07-05-21 10:23","chicken",4,4,5,9,"Village 1"
"73","ea917135-77ac-4f00-a424-3d757bc5f058","06-05-21 16:24","chicken",4,8,1,5,"Village 2"
"74","d31fc041-3a16-441c-aac3-21adfdb8e06d","30-04-21 17:17","sheep",2,0,1,3,"Village 3"
"75","7e98f9f3-0639-465b-9ff0-e39631a6f63e","06-05-21 11:59","dog",4,1,2,6,"Health Centre B"
"76","c058c9a6-2841-4361-ab55-b15454a410a9","05-05-21 17:12","cat",4,4,1,5,"Village 1"
"77","7e6e6f07-a609-4209-a2ac-a0ed2b4c75f8","29-04-21 11:02","pig",1,2,0,1,"Health Centre A"
"78","caba8bd9-c209-4a50-87e4-3f5fc86864df","10-05-21 13:41","sheep",4,6,1,5,"Village 3"
"79","48b7592b-eaad-4720-9806-a50ac1123856","07-05-21 12:26","cat",5,5,2,7,"Village 2"
"80","4b05d989-e694-4b44-9f40-2ff1ff03d636","06-05-21 9:27","cat",6,5,3,9,"Village 1"
"81","191ac3a7-2ebe-4b82-b3c3-f070745f3521","30-04-21 11:43","pig",1,3,1,2,"Village 3"
"82","a7c27998-1641-4270-8066-69f58ca2a32a","05-05-21 17:47","sheep",5,6,0,5,"Health Centre A"
"83","8c5969ec-f9db-43a7-8686-21717b521b44","09-05-21 11:49","buffalo",3,2,4,7,"Health Centre B"
"84","c1c43d68-2be0-4e13-acca-308513410cb8","27-04-21 9:04","sheep",5,2,3,8,"Village 2"
"85","4f4c169a-b60e-49c1-b2c3-10e1bfbf911c","11-05-21 9:25","sheep",3,0,3,6,"Village 2"
"86","634004e8-f1eb-4203-b9f2-81218c26e7d2","30-04-21 9:27","pig",5,0,5,10,"Village 2"
"87","3f3032a5-0a13-4687-8026-739209700587","01-05-21 18:52","sheep",6,5,0,6,"Village 1"
"88","d3d39f76-020c-4313-8dd7-eb7976d9bdef","03-05-21 11:03","buffalo",3,5,3,6,"Health Centre B"
"89","68dc9599-1cb3-4442-aec8-f08f264e9993","29-04-21 17:25","cat",5,7,1,6,"Village 3"
"90","2e0cb649-e037-4334-a4d3-7cd7acb901ca","29-04-21 10:34","dog",6,9,4,10,"Village 1"
"91","ef597b33-2ca9-47d0-b297-dde1c139cf32","05-05-21 14:12","sheep",4,5,1,5,"Health Centre B"
"92","eca49a21-b79f-406f-9453-87e03a6629e6","07-05-21 15:30","chicken",3,3,1,4,"Health Centre B"
"93","87626b8a-64fd-4def-8225-32054d653c4f","07-05-21 16:12","pig",6,0,1,7,"Health Centre B"
"94","ae85a7ad-c76b-4737-b2e3-78f69bbb332c","30-04-21 13:23","dog",3,3,4,7,"Village 1"
"95","5ca45389-6329-4aae-8668-47656222e0da","07-05-21 14:36","dog",6,4,0,6,"Village 1"
"96","cc3f44cc-1e17-4026-bac9-3b75be7ab86a","04-05-21 15:40","buffalo",3,2,2,5,"Village 2"
"97","4c4f2d9a-8ffd-4109-a3f3-165b65e49864","27-04-21 18:53","pig",1,6,3,4,"Health Centre B"
"98","6592b04e-1238-4ff0-aadb-bd3cd07b1a1d","11-05-21 16:34","sheep",2,6,3,5,"Village 1"
"99","0f19701d-fcb6-41ff-9446-ecebf2d9feef","03-05-21 18:03","pig",4,0,0,4,"Health Centre A"
"100","a05b57b1-23d7-4ed2-85a2-6415baab17fc","11-05-21 18:32","chicken",1,5,1,2,"Village 1"
"101","ebb2f13c-de19-4caa-8cc5-11df0bb4b6dc","08-08-21 12:30","dog",1,6,4,5,"Village 2"
"102","d8ea154c-5813-465a-89c9-5b6e7d0a447a","29-12-21 9:49","sheep",5,3,1,6,"Village 2"
"103","6b75605d-1763-4701-89a1-cfa3baafd713","19-09-21 15:02","sheep",2,3,4,6,"Village 2"
"104","039cd69d-31d5-42a9-9e5e-9be37473c235","10-12-21 16:05","cat",6,8,4,10,"Village 2"
"105","871f5670-7771-49f5-a6a5-b6e6aa65102e","08-10-21 10:12","cat",6,9,4,10,"Village 3"
"106","3604d4c2-4b39-449b-a919-fb42ee49240f","11-07-21 14:42","sheep",3,1,3,6,"Village 1"
"107","edf649d8-5383-43fc-8287-f4891ea5a227","27-10-21 16:54","cat",5,9,1,6,"Health Centre B"
"108","225cc9e4-570e-48a0-a254-8944a676e16b","22-09-21 10:12","cat",2,1,2,4,"Village 2"
"109","2113a3bc-d3bb-451c-a09f-aeedd01a9a10","19-05-21 18:39","cat",6,1,4,10,"Health Centre A"
"110","ce76cbce-5f9d-4bf3-a4df-5b9e210ced32","27-08-21 13:53","chicken",5,5,5,10,"Village 1"
"111","390bf63e-7df4-4d00-8f21-c964a55da06e","29-01-22 10:08","dog",6,2,4,10,"Village 1"
"112","c6fe5b6d-dd96-4e85-acda-303e559e2a5a","12-11-21 18:32","chicken",4,7,4,8,"Village 2"
"113","205a2840-0397-4922-8429-b5ea54b0223a","15-04-21 13:21","sheep",5,6,1,6,"Health Centre B"
"114","a2a49dd7-b52f-4ecd-9b22-a5342ef9760d","20-02-22 13:18","cat",3,0,4,7,"Village 2"
"115","e917d048-f86f-402f-8540-3f1dbd0b5e37","15-11-21 16:25","pig",6,2,4,10,"Health Centre A"
"116","403937d5-dd55-4f6c-9d7a-d0c71eff470f","16-05-21 13:25","dog",1,9,3,4,"Village 2"
"117","73da701d-9142-4734-801f-783a6f5d5308","13-09-21 9:53","sheep",3,4,3,6,"Health Centre A"
"118","140cf831-c08c-48ad-9b43-9634f916fbba","25-04-21 15:58","dog",3,2,3,6,"Village 3"
"119","ae89693f-f1ee-4bc5-986b-0079f449e7b4","08-05-21 10:23","buffalo",1,5,1,2,"Village 3"
"120","95643397-dafa-4ef0-bcfe-f4a24d656e6c","29-08-21 10:40","dog",4,4,4,8,"Village 2"
"121","81798cde-9b82-432b-b676-ab91dc532e43","22-09-21 10:05","dog",4,9,5,9,"Health Centre A"
"122","eb76d730-ff9c-4c61-8108-8ae1ac53ed8c","24-07-21 18:40","sheep",1,7,3,4,"Village 3"
"123","e7ce8924-9973-4162-ab09-23da9e9ea267","22-08-21 16:01","chicken",3,3,0,3,"Health Centre B"
"124","c7d478d7-57ff-4283-b22f-eeb605f46d20","27-03-21 18:07","buffalo",6,3,5,11,"Health Centre B"
"125","515c254d-9f00-4898-b8a1-d4dc383cfc1f","03-09-21 15:33","chicken",1,4,0,1,"Village 3"
"126","09fbad34-7200-4e4d-9a19-972566817410","07-10-21 11:12","cat",5,9,2,7,"Health Centre A"
"127","2fc414b8-053e-4542-8e1e-e715dfb2d34e","20-12-21 17:38","chicken",1,6,4,5,"Village 2"
"128","ab8a642c-222d-49b0-a214-deeb2ad33318","19-09-21 11:47","pig",4,7,1,5,"Village 2"
"129","fde27015-2cec-47aa-9b8a-e34017203799","01-02-22 16:51","chicken",6,1,4,10,"Village 2"
"130","19a39dd2-8bec-4999-92c8-dc77ce41040a","10-10-21 12:04","buffalo",3,4,5,8,"Village 1"
"131","f2d0c85b-36f2-456b-9170-3db902541779","07-08-21 10:21","sheep",4,0,5,9,"Village 3"
"132","6c880eca-41c9-4490-bbd6-4c9c26485f46","24-12-21 18:16","pig",6,8,4,10,"Health Centre A"
"133","f701b7c8-a2d0-4832-a3ed-c94db2ebb76a","30-05-21 18:01","buffalo",5,8,0,5,"Village 1"
"134","0edf7ce3-06a2-4a3f-9380-306ee137732d","04-10-21 16:09","buffalo",2,1,5,7,"Village 1"
"135","1f419dcd-61af-4b95-a6ac-d192ac062c22","10-06-21 11:12","sheep",3,1,4,7,"Health Centre A"
"136","fdf67738-c2d2-49d7-ad40-08df7cb49d0f","16-02-22 15:03","buffalo",1,6,5,6,"Village 1"
"137","c66d6803-b5c2-4466-a594-4462603bfbee","25-11-21 18:33","buffalo",4,4,4,8,"Health Centre B"
"138","73bea095-007f-4028-a5b9-e5d18349e9aa","16-10-21 18:32","dog",2,4,2,4,"Village 3"
"139","ad966d1f-dd4c-431a-834e-70b865e35a92","27-07-21 17:53","pig",2,3,2,4,"Health Centre B"
"140","7138777e-e9c8-4595-9bba-dc69d67b9104","17-01-22 16:21","cat",4,8,2,6,"Health Centre A"
"141","c4f97405-8cb8-4382-9790-71fb78686df0","27-09-21 10:48","cat",1,4,2,3,"Village 2"
"142","ad6ea90b-6e94-45fa-9048-b7db4af725c6","02-10-21 13:54","buffalo",1,2,2,3,"Village 3"
"143","c9f52fbc-5306-4cdd-8fe8-00464d2f704c","19-09-21 14:27","sheep",6,7,3,9,"Village 3"
"144","bf5a9a32-9283-4ecc-bab5-2af80481e1b5","08-10-21 16:41","chicken",3,5,1,4,"Village 2"
"145","9c657c79-0236-4409-b11e-53c1b99aca13","18-07-21 13:54","pig",1,3,0,1,"Village 1"
"146","82393e39-99e9-4baa-bcf0-65135ca2e714","21-04-21 16:33","cat",5,2,4,9,"Village 1"
"147","81380ecb-df6e-4e6d-a9ec-045d12dd095d","18-01-22 12:00","dog",1,2,5,6,"Village 1"
"148","9224f6b0-24b3-4aa3-9d50-4670eb0efc78","04-10-21 17:16","dog",2,8,1,3,"Health Centre B"
"149","51685474-f98c-4743-a174-52f4f4070d99","29-01-22 10:01","sheep",2,4,5,7,"Village 2"
"150","eba84070-6367-4e33-b17c-d964d48e9dfc","10-07-21 16:49","cat",3,7,1,4,"Health Centre A"
"151","a530f94f-f757-4f80-a012-1447ba170055","10-09-21 12:46","buffalo",4,3,4,8,"Village 3"
"152","0856eb34-2c0f-43a3-9289-50910e6fcd43","12-05-21 9:55","dog",3,6,2,5,"Village 2"
"153","9e5f0862-79d5-4299-b703-1a4f7ec09bf3","25-08-21 13:15","sheep",2,7,5,7,"Health Centre A"
"154","961945fb-6a04-45b9-919d-b625a069b871","12-10-21 15:47","chicken",5,3,3,8,"Village 3"
"155","78296bfd-916f-46a7-97c7-6ff6e6878232","03-02-22 9:43","sheep",4,8,4,8,"Village 3"
"156","f4baadb1-1663-422a-856f-7e0b0f89706f","09-02-22 15:23","buffalo",1,9,0,1,"Village 2"
"157","3272ca53-c879-4981-9619-25cce9c03b07","30-01-22 11:38","dog",3,3,3,6,"Village 3"
"158","656ccdb4-c65c-41be-a6b1-fb293fbcc7ff","24-10-21 9:38","sheep",5,2,2,7,"Village 2"
"159","fc015249-26c6-4a30-9a99-bb7d2e017a51","31-12-21 14:46","buffalo",3,0,4,7,"Village 2"
"160","ed37769a-ce2d-4a52-8345-20843035638f","19-01-22 9:47","buffalo",1,5,1,2,"Village 3"
"161","d59598c4-8631-4938-9c57-1f7524102041","03-04-21 18:15","buffalo",4,5,3,7,"Health Centre A"
"162","e5725faa-7aee-4b88-a2f0-e905b993705e","19-04-21 12:40","buffalo",6,7,1,7,"Village 2"
"163","cf4c1dcc-83f5-411b-a4e3-da3a6a8e2391","03-07-21 18:40","pig",3,3,0,3,"Village 3"
"164","0f1fd0cf-700b-4f2d-8e90-5da73aafdc85","20-02-22 13:59","chicken",6,5,5,11,"Health Centre B"
"165","43e2860f-381c-4dfd-a352-225a6eb17ce7","04-04-21 12:26","cat",5,5,5,10,"Village 2"
"166","52276db0-846e-4932-836a-ae5be8334019","24-07-21 10:01","pig",3,2,1,4,"Village 2"
"167","80425694-2a1c-4bbd-8651-9defaf71a657","26-09-21 16:09","buffalo",4,3,4,8,"Village 1"
"168","286ddea2-6a3e-4f33-983c-60264e43a0e1","04-05-21 18:06","buffalo",3,8,1,4,"Health Centre B"
"169","e0356fe6-2a29-424e-9fce-023056d72ef4","17-08-21 12:45","cat",1,4,5,6,"Village 3"
"170","ee896803-c458-4f28-b9a3-28283af521e7","03-10-21 11:22","dog",1,2,2,3,"Village 3"
"171","f871430a-2879-4866-8149-821efb9fe75d","24-04-21 14:02","buffalo",1,5,1,2,"Village 1"
"172","823f54f0-9a01-4e66-addb-0b51754b1387","03-09-21 10:03","sheep",5,7,4,9,"Village 3"
"173","d673f29e-a9b7-4837-bbee-4ffe4a43f079","25-04-21 10:37","chicken",1,5,1,2,"Village 2"
"174","eab7ccb9-c906-4bd0-bd1c-eeba5e4ac1c2","01-05-21 18:06","sheep",5,3,1,6,"Village 1"
"175","5d4001d1-2019-4db8-84ea-c61849843005","18-04-21 13:17","cat",6,0,4,10,"Village 1"
"176","be62167c-991a-4506-9058-be5d53cb584f","27-12-21 18:39","dog",3,5,2,5,"Health Centre A"
"177","3b2d08b6-d521-43ba-aead-7e0eb5778b25","10-02-22 15:39","cat",2,4,3,5,"Health Centre A"
"178","544c51ee-87b5-4132-985f-ebc82efa3113","02-12-21 14:34","pig",1,1,4,5,"Health Centre A"
"179","40114f62-27fd-4b24-b752-8ceaf4979280","15-05-21 17:29","pig",6,9,4,10,"Village 2"
"180","07860325-eb28-4705-8297-02c0cae02869","14-10-21 14:10","cat",1,3,5,6,"Village 3"
"181","7acef455-9c99-4a2f-b6fa-db155561f446","20-11-21 10:42","sheep",2,3,2,4,"Village 1"
"182","92f7af30-945c-4722-8d5d-6b4a5714f027","04-11-21 14:20","pig",3,9,4,7,"Village 1"
"183","b1733953-eb71-4650-bd45-62166828369a","22-05-21 9:15","dog",4,0,3,7,"Village 3"
"184","7f6b8185-e397-47be-905f-665d96e610a6","01-02-22 16:55","cat",6,9,0,6,"Health Centre B"
"185","d370a1ed-34b6-4467-9d59-9f80c99e773f","01-11-21 15:00","chicken",6,1,5,11,"Health Centre A"
"186","13d25507-7d52-4398-bbc4-7ba4d15f0099","09-04-21 17:21","buffalo",2,1,5,7,"Village 1"
"187","3b7e2d84-570d-460e-b7c6-8b64a8bcbf22","24-06-21 13:37","sheep",6,9,0,6,"Village 3"
"188","a07a844e-b7da-4e6b-beb3-42dbda9c89cd","09-12-21 9:22","chicken",1,7,0,1,"Health Centre B"
"189","b7172f6b-ed21-4257-b695-4699e055dfc4","16-08-21 16:30","sheep",4,5,5,9,"Village 3"
"190","f4c249db-8ad3-4973-8e2f-3571bda86676","16-12-21 9:28","cat",4,2,4,8,"Village 1"
"191","14e97cbc-1ac2-404f-b1b4-ded0ea51e5e6","17-04-21 16:29","cat",6,7,5,11,"Health Centre A"
"192","2d72a1dd-de11-4403-8b49-8bb379a80ab5","06-05-21 16:49","pig",5,2,3,8,"Village 3"
"193","04cb2a9e-5820-4087-9aab-509e316de59e","10-04-21 18:12","sheep",1,8,2,3,"Village 3"
"194","b46a6d93-c8e1-438b-ac72-1fd560e00d41","30-01-22 11:12","dog",6,8,0,6,"Health Centre A"
"195","6ec612a3-92b6-4f2e-8ec3-d87c802de2cb","13-01-22 15:35","dog",5,3,1,6,"Village 1"
"196","aeda73cd-296a-4436-a817-432e86d53d62","11-05-21 12:20","dog",2,1,1,3,"Village 2"
"197","cb7e6555-82a1-469a-b0f9-de33fc6a361a","07-06-21 17:38","pig",1,7,3,4,"Village 3"
"198","a7cdbe64-8532-4712-b826-56b18c15b2cf","13-08-21 12:00","dog",3,2,1,4,"Health Centre A"
"199","9cc78969-0c5c-42a0-9a21-31bf536ec16d","08-12-21 16:29","buffalo",4,2,1,5,"Village 1"
"200","37c8fcfc-6b7b-4d3d-8623-6a366faeb60c","03-11-21 11:33","cat",5,1,3,8,"Health Centre B"
"201","f561da15-093d-47c2-85c3-57fe5c9756ae","2021-05-03 13:03:04","buffalo",2,3,2,4,"Health Centre A"
"202","3d955abe-d1e5-4693-be7e-705514f9b22b","2021-05-07 17:57:20","buffalo",6,0,3,9,"Village 3"
"203","d91226c9-f6fd-4b10-89e9-7c17a61bf9d4","2021-05-06 15:35:33","pig",3,7,5,8,"Village 2"
"204","d924d6fa-3c9f-4c8a-bd5c-41ee5620ade4","2021-05-02 18:39:48","buffalo",4,8,4,8,"Health Centre A"
"205","b20d66e7-5bdf-4b59-a42b-903edc8d975a","2021-04-28 16:25:45","pig",4,1,3,7,"Health Centre A"
"206","80f45d31-dc55-418a-b506-d425d3c624ee","2021-05-02 12:03:06","buffalo",2,5,2,4,"Health Centre B"
"207","2f1f12c9-e89e-41c6-8e8b-a894becd2872","2021-05-05 15:38:34","buffalo",1,8,5,6,"Village 3"
"208","5123f472-a744-4a28-93ab-a28634f5678e","2021-05-09 11:53:15","chicken",3,4,2,5,"Village 2"
"209","fb61060b-6fad-4952-8f51-0360b214feb3","2021-05-07 14:00:58","chicken",4,9,5,9,"Health Centre B"
"210","413ef91b-3d65-4db7-88af-2106e37878ef","2021-04-28 11:23:11","chicken",2,4,3,5,"Health Centre B"
"211","5531b4ea-92c0-4685-b29e-1d5879fbea3d","2021-05-02 16:16:26","cat",5,2,4,9,"Village 3"
"212","52a09cdd-2b8f-4ce3-a6ab-07f0cb53350f","2021-04-28 10:51:29","sheep",4,9,5,9,"Health Centre B"
"213","01b4aa5c-cbd6-486d-a19a-9d6d3722732f","2021-05-10 15:31:17","pig",3,7,4,7,"Village 1"
"214","3425abd1-7e52-4d03-ad67-da24a6de79d4","2021-05-04 18:52:23","sheep",5,4,5,10,"Village 1"
"215","48d7bc70-1f28-4b0a-bb1b-929062e09b3a","2021-05-06 13:09:51","chicken",4,0,3,7,"Health Centre B"
"216","63238c84-80ea-4d2d-94a9-bba5511ba2b9","2021-05-03 10:47:15","cat",2,9,0,2,"Village 1"
"217","35a0a49d-7e9a-4acf-b45f-5bfa7aeb3dfb","2021-05-06 15:43:55","pig",1,6,0,1,"Village 2"
"218","77f290ef-5be6-427c-8975-1fcb300af149","2021-05-04 13:32:48","chicken",4,1,4,8,"Village 3"
"219","15a7d7bf-b7c6-4b15-9b45-2b73db3f5ee1","2021-05-06 16:49:39","sheep",1,1,1,2,"Village 1"
"220","a22293da-7b77-43b8-84f4-dcaca99a754b","2021-05-11 09:11:17","buffalo",1,9,4,5,"Village 1"
"221","3b3e365d-10ad-4d79-9f8c-6fc5ee46ade0","2021-05-04 17:16:40","chicken",6,9,3,9,"Village 3"
"222","47e8e058-cbc3-47ee-99a9-563a4a174d9f","2021-04-28 16:05:44","chicken",1,3,2,3,"Village 1"
"223","c9ebfe10-1364-45c0-906f-fb7f003ff6a9","2021-05-01 12:59:28","cat",6,8,0,6,"Village 2"
"224","722d428e-409f-4e84-9537-8186781729a6","2021-05-10 17:57:34","dog",1,8,2,3,"Village 1"
"225","8049f526-47b7-4578-9da5-5cf0ff7c9d3c","2021-05-03 13:07:30","pig",5,2,4,9,"Health Centre A"
"226","48b75542-1867-4f87-940a-8f8688fa764d","2021-05-07 10:46:23","cat",6,1,3,9,"Village 1"
"227","2968fd7f-71f2-4d77-91ec-33e3c9c624f4","2021-05-01 16:44:34","buffalo",1,3,1,2,"Health Centre B"
"228","1eb38c01-ee7a-4505-b4ec-bc0c1c74cc4d","2021-05-07 10:10:04","pig",2,2,5,7,"Health Centre A"
"229","fd8f5ba1-392b-4f54-bcae-ebc47ca8cc2b","2021-05-09 12:05:22","sheep",5,6,4,9,"Village 2"
"230","7aa06765-e081-40b8-a744-6e8a94cbcbdd","2021-05-02 09:27:47","chicken",2,6,4,6,"Village 2"
"231","f3b90d3f-1e40-48b8-b280-092e68d85ed6","2021-05-08 15:23:55","chicken",5,2,2,7,"Village 3"
"232","d0d27709-f495-45ff-b7bb-0b19fae3070b","2021-05-06 12:47:09","chicken",1,5,5,6,"Health Centre B"
"233","38e28b2b-6dd5-4a8e-9ffc-52c06fa59e0b","2021-04-27 16:18:45","cat",6,6,5,11,"Health Centre B"
"234","cabc13bd-0614-4e42-b61e-6e619a595daa","2021-05-11 12:15:49","cat",4,1,5,9,"Village 2"
"235","0efcf980-e99b-40d9-b7df-7b6ef564ecdd","2021-04-30 10:21:07","dog",6,6,1,7,"Village 3"
"236","b0b50139-43a3-4598-8c67-6f15467bb5e9","2021-05-03 13:36:14","sheep",3,5,1,4,"Village 3"
"237","f2f0e9b0-d535-4e0f-820f-3a04411bb984","2021-04-27 10:30:45","dog",1,7,3,4,"Health Centre B"
"238","d916ba3f-db9e-4830-9bfe-52935ac077f5","2021-05-01 15:00:22","pig",4,4,1,5,"Health Centre A"
"239","e3170651-fc1b-48e9-bf0d-825c29faa71c","2021-05-05 12:19:59","buffalo",4,6,3,7,"Village 3"
"240","fcef705c-d220-4149-a4e4-34a6425bd010","2021-05-06 18:54:18","sheep",3,3,4,7,"Health Centre A"
"241","10f4d5fb-6254-4e9a-9ed9-28b779f75bc3","2021-04-29 16:04:12","chicken",6,5,2,8,"Village 1"
"242","ea08847a-ede5-451a-923d-f2bdae8802a4","2021-04-30 18:21:39","pig",6,2,2,8,"Village 2"
"243","952e7dd5-f4cf-4b14-926f-f6aeb29ae919","2021-05-10 11:28:02","chicken",1,3,5,6,"Health Centre B"
"244","b2c5ec73-4b07-44e1-ba1e-7a075d26ed9e","2021-05-03 12:49:53","dog",2,3,4,6,"Village 2"
"245","9db0fb5e-479e-4d9e-85ba-9f7e1219953a","2021-05-01 14:11:13","cat",4,0,0,4,"Health Centre B"
"246","7af38f52-e531-4856-9bb6-3a2f56a40c97","2021-05-10 15:46:51","pig",3,1,4,7,"Health Centre B"
"247","6759fded-4e12-44de-963c-5fa976a8be3e","2021-05-09 14:12:09","dog",6,6,5,11,"Village 1"
"248","4e94bfb2-e904-4490-a1d4-39889408fae8","2021-05-03 17:46:59","buffalo",3,5,0,3,"Village 1"
"249","25222359-5b06-4f55-9d63-340ce648d015","2021-05-04 16:41:37","sheep",4,2,2,6,"Health Centre A"
"250","58d0fd0e-81dc-45c6-8e41-91f5c4ef887c","2021-05-10 14:44:31","pig",1,9,1,2,"Health Centre B"
"251","b19d113a-7bfd-4deb-b0bc-dfe1375fbbb6","2021-05-02 16:31:08","cat",5,9,1,6,"Health Centre A"
"252","3e359414-5e0c-430f-9292-94adf5a4ffea","2021-05-07 11:25:27","sheep",1,0,0,1,"Village 3"
"253","ccd206c0-6311-4082-b6b9-78b804d03d42","2021-05-06 09:04:37","buffalo",2,6,0,2,"Village 2"
"254","36273728-6800-4b95-ac29-4a6392e3749f","2021-04-28 17:42:01","dog",2,7,5,7,"Health Centre A"
"255","506ad6f9-2e44-40fb-9178-472b1a89db45","2021-05-06 13:27:52","buffalo",1,7,0,1,"Village 1"
"256","b3e5bf85-a98e-40ec-b49c-21d162177ab5","2021-05-09 12:14:34","dog",6,4,0,6,"Village 2"
"257","c91b8043-a589-4643-a99b-08119c587bae","2021-04-30 16:56:12","dog",5,5,3,8,"Village 1"
"258","a3e6cc6e-3eb5-4c7b-9ab7-150b53eff07a","2021-05-11 10:41:12","cat",3,1,1,4,"Health Centre A"
"259","fcfb000a-493b-4ec1-ab34-b7a063e6b317","2021-05-07 11:35:11","sheep",6,9,3,9,"Village 3"
"260","6b8faa6d-5adb-4f19-8a4b-4bd45eb856a8","2021-04-29 14:37:39","dog",6,0,5,11,"Village 3"
"261","622527f8-98ac-46b7-816f-ebf61f2409c9","2021-04-28 18:36:09","pig",5,2,5,10,"Village 2"
"262","c05555ba-5f03-4541-b6f0-d43a80a01c7b","2021-04-27 09:21:34","cat",6,7,4,10,"Village 3"
"263","aba56491-ef96-47cc-898f-02b2eb637654","2021-05-11 13:12:43","buffalo",5,7,0,5,"Village 2"
"264","d715ffac-1ef6-4bf4-ad43-c62f50dc2543","2021-05-02 11:52:51","pig",3,4,0,3,"Village 2"
"265","74f61bb8-0112-43fc-b951-de231d13f09b","2021-05-10 09:43:28","dog",6,5,4,10,"Village 2"
"266","993e0384-ef2f-4308-88d7-f9143f3a6b14","2021-04-27 16:37:41","buffalo",6,1,5,11,"Village 2"
"267","87565a80-44fe-49ef-bd88-ba7eb8ca922b","2021-05-08 11:37:20","sheep",2,8,1,3,"Village 2"
"268","1eec1c54-75d0-472b-92de-e482587cf8e5","2021-05-08 13:52:05","chicken",5,6,5,10,"Village 1"
"269","0f70e08a-3b80-406b-a37a-ed7ded821985","2021-04-29 18:06:14","pig",4,5,1,5,"Village 1"
"270","047caa23-aa63-427b-8524-98ac2a252816","2021-05-02 11:16:13","cat",5,8,2,7,"Health Centre A"
"271","4016bb87-4872-495c-b90a-998531f6f034","2021-04-27 12:48:43","sheep",3,4,0,3,"Village 2"
"272","21aed2f7-31f5-4db0-80b7-58fdd2080cb8","2021-05-07 16:45:46","buffalo",6,9,3,9,"Village 2"
"273","e545e6ca-302d-4932-a237-167121f8efa5","2021-04-27 14:07:01","chicken",4,6,4,8,"Village 3"
"274","532da0a9-54bd-470c-9d29-781907bdae6a","2021-05-02 14:50:51","sheep",4,2,3,7,"Health Centre B"
"275","e1bdbc85-5752-4a67-9b1d-b8744981d3ff","2021-05-02 17:28:09","chicken",5,2,1,6,"Village 3"
"276","1bc6a269-a88a-41bb-afd8-30ebdcfc6972","2021-05-01 09:07:13","buffalo",2,9,1,3,"Village 1"
"277","baf0033d-1094-4fd8-8ed0-c02b3dbc07b0","2021-05-03 16:16:45","sheep",5,4,2,7,"Village 2"
"278","6945196e-7be3-4925-bd70-7cf1fbda6e3e","2021-05-01 13:39:02","dog",3,2,4,7,"Village 3"
"279","f6078da0-12ce-4844-a6c3-127191b64d9d","2021-05-05 17:06:13","sheep",2,8,3,5,"Health Centre B"
"280","2407b664-5725-48da-aee5-2ff6b398d42d","2021-05-09 10:18:54","pig",3,2,1,4,"Health Centre B"
"281","6f9bf83d-55d8-4e8e-93b1-69e4a0f55444","2021-05-05 10:17:07","chicken",3,8,4,7,"Village 2"
"282","20d0d8d9-90d1-48ff-84b6-c33e8d81a045","2021-05-10 09:04:10","sheep",2,4,5,7,"Health Centre A"
"283","c0644cd0-190d-4b4c-ab4b-fe4986015e78","2021-05-07 17:49:26","chicken",1,7,1,2,"Village 3"
"284","c3659e71-ceca-4dbb-b3a0-65a5b274dcd6","2021-05-05 09:44:16","cat",2,6,3,5,"Health Centre B"
"285","4afa4186-8370-419d-a21d-afe21f57a02f","2021-05-03 12:25:12","pig",3,2,4,7,"Health Centre B"
"286","483a5778-9581-409c-9c07-6590fde7cb97","2021-05-05 15:11:31","chicken",2,9,0,2,"Village 3"
"287","a470caf6-73bd-4b31-9044-21d3271cb343","2021-05-02 12:25:44","dog",1,5,0,1,"Health Centre B"
"288","fb870fa7-439a-4e3a-be05-fa04fa766304","2021-04-27 13:43:20","dog",4,8,0,4,"Village 3"
"289","9e197e6e-2c24-42f0-9fc5-a6ddc57998ac","2021-05-09 18:30:40","cat",3,2,4,7,"Health Centre B"
"290","fbc81acc-e124-4a48-b98c-39ffb9473178","2021-04-28 11:43:18","buffalo",3,0,3,6,"Health Centre A"
"291","620cc79e-5f46-4ff8-9128-153175e990e2","2021-05-07 11:52:09","buffalo",3,9,0,3,"Health Centre A"
"292","15edb273-0637-46c7-a691-6d218ce61bb6","2021-04-30 09:48:18","pig",3,7,5,8,"Health Centre B"
"293","7b038548-c714-4aa4-84a3-01990e253ab1","2021-04-28 15:57:59","pig",6,1,1,7,"Village 2"
"294","3086d58c-1de5-4f89-9fc5-8d308875763d","2021-05-05 10:24:09","cat",6,7,3,9,"Health Centre A"
"295","80d4aa48-c11d-4fa4-9414-c03e2a71f589","2021-05-02 09:18:58","chicken",2,4,5,7,"Health Centre B"
"296","0c54b15d-1cff-47a5-aa53-76bd55a5c4ce","2021-05-01 14:12:02","dog",5,1,3,8,"Village 3"
"297","7ba23d21-2e1c-4a90-9d84-72b07c511e2b","2021-05-09 14:34:53","buffalo",2,4,5,7,"Village 3"
"298","3034102a-f2cc-40bc-8559-5e53277c5ed7","2021-04-28 15:05:41","pig",1,8,3,4,"Health Centre B"
"299","f0199dd0-a507-4b28-95b9-dd6bd9b05707","2021-05-09 09:16:48","dog",3,0,3,6,"Health Centre A"
"300","394fe68e-bd8f-4cdb-b52f-7865a62201e5","2021-04-27 12:41:37","sheep",4,9,1,5,"Health Centre B"
"301","bc36d11c-b49c-4032-805b-b64681f1cb01","2021-06-27 13:27:15","dog",6,0,3,9,"Village 2"
"302","a0150d3e-5706-44d9-aaab-e3c31b1b9536","2022-01-27 18:49:04","dog",4,6,4,8,"Village 3"
"303","de218afb-4256-4fa2-9f26-c8ad2d6af1c8","2021-05-13 16:09:13","dog",1,4,2,3,"Health Centre A"
"304","b6ba303b-81c0-4419-9264-3d392eef1575","2021-09-25 14:16:52","dog",5,8,4,9,"Health Centre B"
"305","9ec0aa24-c8aa-4210-ac48-75d7d4444115","2021-05-04 16:34:05","chicken",4,8,4,8,"Health Centre B"
"306","f4bde093-af74-425d-99b2-bf2d1fbb9b0b","2021-08-12 09:32:51","cat",1,7,2,3,"Village 1"
"307","c73f087f-bb93-4555-9615-4d43e30fe059","2021-10-24 17:16:43","cat",3,1,1,4,"Health Centre B"
"308","95668c96-505f-4d3f-bfbf-37518e8bfe01","2021-04-13 18:41:53","cat",6,4,5,11,"Village 3"
"309","839bf203-83b2-4483-84af-ec4ece2ab5ad","2021-06-30 18:35:56","cat",1,2,4,5,"Village 1"
"310","71b5ea9e-98e8-4acc-8d40-50ac5f762a39","2022-02-20 18:42:29","buffalo",2,1,0,2,"Village 3"
"311","ee5ab157-efba-4853-9021-db5c85714649","2021-06-19 14:08:42","cat",6,6,3,9,"Village 2"
"312","7fc8d356-ec65-4c6b-baff-5cf50fd7f00a","2022-01-13 18:47:57","chicken",2,9,1,3,"Village 1"
"313","69e0248b-8df2-497d-a681-6487edcab31f","2021-09-07 10:45:00","chicken",2,1,3,5,"Village 2"
"314","4d69af03-c1e1-49cd-a022-5235ecb3f58c","2021-11-08 09:38:48","sheep",2,5,3,5,"Village 2"
"315","68f52808-aed2-46e9-a945-827eb18213d2","2021-06-29 17:47:59","cat",2,1,3,5,"Health Centre A"
"316","b15a99fe-0701-40d6-8beb-71a71921acdb","2021-09-15 10:14:35","dog",6,0,4,10,"Health Centre B"
"317","1349ecd6-49f4-4349-9c5f-6838c7f278af","2021-07-30 15:22:55","buffalo",4,2,5,9,"Village 1"
"318","58c3c94c-748e-4db0-a88d-66ccef042ecb","2021-07-22 17:11:15","pig",2,6,5,7,"Health Centre A"
"319","776a26b7-d506-4e99-b566-91875c229a99","2022-01-17 17:56:45","chicken",6,9,1,7,"Health Centre B"
"320","da23ae8a-1a12-42f7-8800-a6dc1b6d54bf","2021-06-02 17:32:11","pig",5,4,5,10,"Village 1"
"321","ca4851a2-872b-4868-acfe-791c3e9befaf","2021-11-12 11:55:42","chicken",4,0,4,8,"Village 2"
"322","a6ccf8ac-1fca-415c-9f06-6f23286900f1","2021-08-20 14:57:19","buffalo",5,4,2,7,"Health Centre A"
"323","fc751f46-d3d5-48bb-b639-14525742dd43","2021-08-07 13:27:50","buffalo",1,6,2,3,"Health Centre A"
"324","707ae007-77a2-4703-9e22-47ea91d84208","2021-10-11 10:40:13","chicken",1,6,3,4,"Village 3"
"325","7ee75178-a365-4600-887b-26fa8f22bfa3","2022-01-15 16:05:47","sheep",1,9,4,5,"Health Centre B"
"326","81aeb23b-8371-4558-8e21-430c416d75ca","2021-12-05 18:32:12","pig",1,9,5,6,"Village 1"
"327","cfae1f70-a5ec-459a-ac75-1ff3b1e3865c","2021-11-25 13:49:15","sheep",1,5,3,4,"Village 2"
"328","a1e9a700-7ab2-4f32-8015-74c68e40084f","2021-08-08 09:26:39","chicken",1,3,3,4,"Village 1"
"329","c43e4c39-20c6-4fdf-9fe4-d19776e8d735","2021-04-09 16:06:51","sheep",2,2,0,2,"Health Centre B"
"330","049525ff-c1b9-4492-8efe-57d9fac70cf8","2021-05-14 12:49:27","chicken",6,8,5,11,"Village 2"
"331","fc954e6a-9d0a-49d5-9caf-e735b41e1eed","2022-01-30 14:21:52","buffalo",6,5,0,6,"Health Centre A"
"332","9dab6f3b-0b1e-447b-b7ad-8a82ddec48ec","2021-03-19 15:52:31","chicken",1,5,5,6,"Village 1"
"333","c38f282d-79b3-4270-b8b8-dd3d9bb9c948","2021-07-02 12:56:27","buffalo",2,2,5,7,"Health Centre A"
"334","565eb286-3dbd-4777-b4f1-0aeb650e4bbb","2021-04-01 16:57:51","dog",3,7,1,4,"Health Centre A"
"335","6118a60d-fedf-4a24-9200-22878652d67a","2021-04-03 09:16:35","dog",4,7,1,5,"Village 2"
"336","c1b9c107-2795-40d8-a3a6-45ca3db95d15","2021-11-25 12:48:09","pig",1,3,3,4,"Village 2"
"337","ea0c8ddd-4740-47bb-bbad-c35a292d90b1","2021-09-04 16:45:54","sheep",3,8,0,3,"Village 1"
"338","0773860f-66ec-4ed8-89c6-28b4ba852708","2021-07-30 11:51:13","dog",3,1,3,6,"Health Centre B"
"339","176e47c0-c9e9-4ab1-8422-040799744f06","2022-01-07 11:35:31","dog",3,9,1,4,"Village 1"
"340","da43e810-01fc-427d-be6b-6dcc5bad1f50","2021-11-29 13:46:34","chicken",6,6,4,10,"Health Centre B"
"341","50d5687e-c7cd-44b4-8038-803723167bdd","2022-01-26 09:05:37","sheep",4,2,1,5,"Village 3"
"342","1a45a55a-e216-4926-a9c0-eca0f6baccbc","2021-03-30 14:56:36","chicken",2,4,4,6,"Village 3"
"343","0177cf7c-a8e0-43aa-be70-b89ce663701e","2022-01-31 17:42:14","pig",6,2,4,10,"Health Centre B"
"344","448c09f2-c28a-4f29-833c-937d5d81c72f","2022-01-01 17:13:52","pig",1,6,1,2,"Village 2"
"345","a4038041-6ac5-462c-800d-e176addbdf5a","2021-03-26 16:48:53","dog",1,3,1,2,"Health Centre A"
"346","fc5c69e1-f585-4ab0-8803-17f4b615bea9","2021-05-02 09:21:00","buffalo",1,0,0,1,"Village 3"
"347","baa02dea-2c0a-4048-b7e2-eb6002b33a3d","2021-10-11 17:20:08","buffalo",4,6,3,7,"Village 1"
"348","0432860c-eee1-4575-ba0a-a7ff134efa35","2021-12-30 13:35:45","cat",5,8,1,6,"Village 3"
"349","d16a9b75-9bb2-4f90-874a-ae9f9fa1c512","2021-06-24 12:16:46","pig",2,7,3,5,"Village 1"
"350","a755dff8-c775-4a46-a27c-b00f3ea5629f","2021-04-02 13:20:43","cat",3,8,5,8,"Village 2"
"351","0753fd25-1e70-44c1-8b81-e83d890bb442","2022-01-18 17:34:53","pig",2,8,4,6,"Health Centre B"
"352","9a41c5d3-787b-400f-a1a2-ff4048d8515e","2021-12-12 12:45:47","pig",5,4,2,7,"Village 1"
"353","f43a369c-3a85-4dc4-8f93-f74e4c87e77c","2021-04-01 14:08:59","cat",3,0,0,3,"Village 3"
"354","cfad1309-0f1f-4d3e-a9c3-12acbe802998","2021-05-26 09:30:48","pig",6,9,2,8,"Village 2"
"355","cdb3b23b-2f6f-463d-8244-2874ab084716","2022-01-22 16:14:12","chicken",4,8,3,7,"Village 2"
"356","9896d8bb-67d6-4a7a-9744-13395bb59aaf","2022-02-20 14:39:36","pig",1,4,2,3,"Village 2"
"357","366c5ef8-400c-4767-9662-a3b0227f2ed8","2021-08-29 15:38:18","dog",1,2,3,4,"Health Centre A"
"358","bba12da2-af72-490a-a2b1-4088136fecc5","2022-01-16 15:24:37","chicken",6,8,4,10,"Health Centre B"
"359","ee66cc56-2ad2-4695-8c68-2510fa0a7d74","2022-01-11 16:37:27","chicken",5,1,5,10,"Health Centre A"
"360","07255253-f88d-4629-8a45-dbf5e3024def","2021-09-09 15:55:25","cat",1,3,1,2,"Village 1"
"361","645d97d4-2299-4f72-8816-353ab9e955bd","2022-01-25 12:15:01","buffalo",6,5,0,6,"Village 2"
"362","0457b89a-29d4-4d2a-a294-8882e5579983","2021-05-09 11:40:43","dog",1,6,5,6,"Village 1"
"363","a3eea1bd-b486-4bda-b266-0d6f75e7606b","2021-08-08 11:54:27","chicken",3,3,1,4,"Village 1"
"364","3c8c6f32-d6dc-4ea4-a6ef-1d5c7192d0f2","2021-07-20 16:38:49","cat",5,7,3,8,"Health Centre B"
"365","9eab7729-19ff-4df2-9b94-ef1d06d34b35","2021-12-26 18:23:01","buffalo",4,8,0,4,"Village 3"
"366","a2cc3061-6d3e-4c1a-9e9f-e8b465dc0ddf","2021-04-02 15:51:49","chicken",1,8,2,3,"Health Centre A"
"367","8d3245b2-30c3-4bec-880c-6580ee2b656d","2021-07-16 13:57:51","buffalo",2,8,0,2,"Village 1"
"368","6f5957c0-5f41-4c6d-943c-350a2d1a9d86","2021-12-14 14:47:44","cat",4,0,0,4,"Health Centre B"
"369","a1e0c6ba-ac3c-4f17-bb99-343c79d10910","2021-06-27 14:13:50","cat",6,2,2,8,"Village 3"
"370","ef8ba84f-ab7e-4286-80b5-406975240f91","2021-05-04 10:03:08","chicken",2,5,5,7,"Health Centre A"
"371","bdaedfd9-5426-43d2-a8d7-0f3a7012d906","2021-04-08 09:27:08","pig",3,1,4,7,"Village 2"
"372","76cc3837-2220-4402-8e4b-8c17dc95bd48","2021-11-16 16:43:02","cat",5,5,1,6,"Village 2"
"373","07dcd3ab-2957-4108-ad26-03a12b6512b8","2021-06-11 09:37:51","pig",2,9,1,3,"Village 1"
"374","14bbb7bf-eb14-4f54-ae5e-73a1164da668","2021-05-28 13:30:36","pig",6,1,1,7,"Village 1"
"375","78533984-bc16-40bd-9e74-ac3c4f4269ea","2022-02-02 11:28:16","dog",2,0,1,3,"Village 1"
"376","8325a0d4-ecdb-412a-a157-41ae276db6fa","2021-11-03 18:46:20","cat",2,3,4,6,"Village 3"
"377","ed185d60-7dc7-4e19-94b1-5d173147ad30","2021-12-10 09:00:30","pig",6,4,2,8,"Village 3"
"378","8543fd41-e5b7-42a3-8956-46af16ccadfd","2021-10-11 14:37:42","sheep",6,8,5,11,"Village 3"
"379","1e14a288-1e03-47aa-9277-eb91964eb56a","2021-03-22 12:53:20","dog",5,0,3,8,"Village 1"
"380","8a54c665-8989-4e5d-81df-e0db2a9c6fd4","2021-07-30 16:26:55","pig",5,1,1,6,"Health Centre A"
"381","83bf4f47-cd3e-4891-b21e-7c067cda15eb","2022-02-20 16:11:09","cat",2,7,0,2,"Health Centre A"
"382","55e19f84-72fa-44c1-b090-b73bb64e43ad","2021-05-05 17:43:13","buffalo",4,3,3,7,"Village 3"
"383","2aed13a4-a283-419f-9634-6049a296b242","2021-04-12 15:35:50","buffalo",3,1,5,8,"Village 2"
"384","6b06b698-f96f-4a66-8e66-161ee0e6d4d4","2021-05-10 13:16:37","chicken",5,7,1,6,"Health Centre B"
"385","b56c8158-5e18-4a44-80c2-e177ed7cd277","2021-07-30 14:51:36","cat",4,3,1,5,"Health Centre A"
"386","10b6f6b5-6680-4bd0-ba70-375075a546fe","2021-06-26 14:08:35","buffalo",1,8,5,6,"Health Centre B"
"387","ea72c7fe-d08f-4200-b9a2-855d30ff77f6","2021-05-26 12:36:46","cat",6,5,1,7,"Health Centre B"
"388","61c8e9cf-efa0-4f0c-83de-374180ef0df9","2021-04-26 09:03:28","cat",2,2,5,7,"Village 1"
"389","5c9d740c-556b-4b3a-8416-a33110534d02","2021-08-16 18:15:55","pig",3,7,2,5,"Village 1"
"390","f6157200-6c17-4d67-9299-21eac1e67284","2022-01-18 13:46:48","buffalo",3,1,5,8,"Village 1"
"391","cbb889f1-a83a-4086-ad01-c39f4366cd27","2021-12-19 09:15:14","dog",2,4,1,3,"Village 1"
"392","4764c0e5-453e-4929-baa0-c5f18ad7986d","2021-09-21 10:28:12","dog",1,3,4,5,"Village 2"
"393","aa8135eb-67db-4da4-8390-9c19896f2e67","2021-04-02 18:32:07","sheep",5,5,0,5,"Health Centre A"
"394","0d1ce08f-35e0-417f-97bc-d08a978bdd9e","2021-10-26 13:52:21","buffalo",3,2,3,6,"Health Centre A"
"395","9e7ea022-5b2a-493d-beb0-8911b3f40bcb","2021-04-30 18:34:11","buffalo",3,0,4,7,"Village 2"
"396","33af308d-70e3-405a-b9a9-e53b333aa7c0","2021-05-01 09:42:14","sheep",5,8,0,5,"Health Centre A"
"397","bbd9e5ec-7f73-44d7-824f-6df97fe141bd","2021-10-07 12:08:24","dog",4,5,3,7,"Village 3"
"398","9af040ac-1a2c-408e-aa51-39b3b524fabb","2021-09-09 17:02:25","dog",4,3,0,4,"Village 3"
"399","c2409459-209b-41c5-bca3-27a45a185f6c","2021-09-26 12:59:47","buffalo",1,7,0,1,"Health Centre A"
"400","9e1f9825-1049-45de-914a-7227660bae78","2021-09-19 18:16:54","pig",4,9,0,4,"Health Centre B"
